###############################
#     #  #  #  #     #        #
####  #  #  #  #  ####  #######
#     #  #        #  #     #  #
#  #  #  ####  #  #  #  #  #  #
#  #  #        #  #     #     #
#  #  ####  #  ####  ####  ####
#  #        #  #     #  #  #  #
#  ####  #######  ####  ####  #
#  #  #           #     #     #
#  #  #  #  ####  ####  #  #  #
#     #  #     #  #     #  #  #
#  #############  #  ####  #  #
#     #  #        #  #  #  #  #
####  #  #######  #  #  #  ####
#        #                    #
#  ####  #  ##########  ####  #
#     #  #  #  #        #  #  #
#  ####  ####  #######  #  #  #
#  #        #        #     #  #
#  ####  #  #######  #  ####  #
#  #     #     #           #  #
#  #  #  ##########  ####  ####
#  #  #  #  #  #     #        #
##########  #  #  #######  ####
#     #  #        #  #  #     #
####  #  #  #######  #  ####  #
#              #  #           #
####  ####  #  #  ##########  #
#        #  #  #  #           #
#  ##########  #  #  #  ####  #
#     #        #     #  #  #  #
#  ####  ####  #######  #  ####
#  #  #  #  #  #        #  #  #
#  #  ####  ####  #  ####  #  #
#  #     #  #  #  #           #
#  ####  #  #  ##########  ####
#           #  #              #
#  ####  #  #  #######  ####  #
#  #     #        #     #  #  #
#  ####  #  ##########  #  ####
#     #  #  #  #  #        #  #
##########  #  #  #######  #  #
#     #  #  #  #  #           #
#  #  #  #  #  #  ##########  #
#  #     #     #  #  #  #     #
#  ####  #  ####  #  #  #######
#  #           #  #     #     #
####  ####  ####  #  #######  #
#  #  #  #  #  #  #     #     #
#  #  #  #  #  #  #  #  ####  #
#        #  #  #  #  #     #  #
#  #  ####  #  #  #  #  #  #  #
#  #  #  #           #  #  #  #
#  #  #  ####  #############  #
#  #  #  #        #     #     #
#  ####  #  ##########  #  #  #
#  #     #     #     #     #  #
#  ####  #  #  ####  ####  ####
#     #     #        #        #
#######  #######  ####  #  ####
#           #           #  #  #
#######  ###################  #
#                 #     #     #
#  ##########  #  ####  ####  #
#  #     #     #  #        #  #
#  #  ####  #  #  #  #######  #
#        #  #  #           #  #
#  ##########  #  #######  #  #
#        #     #  #     #     #
#  ##########  #######  #  #  #
#  #  #           #  #     #  #
#  #  ####  #  #  #  #  #  #  #
#     #  #  #  #  #     #  #  #
#######  #######  ####  #######
#              #     #  #     #
##########  ####  ####  #  ####
#  #                 #  #     #
#  #  #######  #############  #
#  #  #     #        #        #
#  #  #  ####  #######  #  ####
#           #  #        #     #
#  #######  #######  #  #  #  #
#        #  #  #     #  #  #  #
####  #######  #  ##########  #
#              #        #     #
##########  #  #  ####  ####  #
#  #     #  #     #     #     #
#  ####  ####  #  ####  ####  #
#           #  #  #  #  #  #  #
####  ####  #  #  #  ####  #  #
#        #     #  #     #  #  #
#  #  #######  ####  ####  #  #
#  #  #     #     #  #  #     #
#  #  ####  #  #  #  #  ####  #
#  #     #     #  #           #
#  #######  #  ####  ####  #  #
#  #  #  #  #     #  #     #  #
#  #  #  ####  ####  ####  #  #
#        #        #  #     #  #
#  #  ##########  ####  #######
#  #  #  #           #        #
#  ####  #  #  #############  #
#     #  #  #  #  #     #     #
#  ####  #  #  #  ####  #######
#     #     #     #     #     #
####  #######  ####  #  #  #  #
#     #        #  #  #     #  #
#  #  ####  ####  ####  ####  #
#  #     #  #     #        #  #
#  #######  #  ####  ####  ####
#  #     #  #        #        #
#  #  #############  ####  #  #
#        #  #  #     #     #  #
#######  #  #  ####  #######  #
#     #     #           #  #  #
#  #  #  ##########  #  #  ####
#  #        #     #  #  #  #  #
#  ####  #######  ####  #  #  #
#     #  #  #        #        #
#  #######  ####  ####  ####  #
#                 #  #  #     #
#######  #  ####  #  #  ####  #
#        #  #  #        #  #  #
####  #  ####  ##########  #  #
#  #  #           #           #
#  #######  ##########  #  #  #
#        #  #           #  #  #
#  #############  ##########  #
#        #     #     #        #
#  ####  ####  #  #######  ####
#  #     #              #     #
#######  #  #  #############  #
#  #  #     #  #  #     #     #
#  #  #  #  #  #  #  ##########
#        #  #  #     #     #  #
#  #############  #  #  #  #  #
#           #     #     #     #
#  #######  #  ####  ##########
#  #  #  #     #     #  #  #  #
####  #  ####  #######  #  #  #
#  #        #           #  #  #
#  #  #######  #######  #  #  #
#              #        #     #
#######  #  #  ####  ####  ####
#        #  #  #        #     #
################  #  #  ####  #
#  #  #           #  #  #     #
#  #  #  #######  #######  #  #
#        #           #     #  #
#  ####  ####  #  #  #  ####  #
#  #  #  #     #  #  #  #  #  #
#  #  ################  #  ####
#  #     #     #     #        #
#  ####  #  #######  #  #  #  #
#     #        #     #  #  #  #
#  #  #  #######  ####  #######
#  #  #  #              #     #
####  #  ##########  #  #  ####
#                 #  #        #
#  #######  #############  #  #
#  #     #           #  #  #  #
#  #  #############  #  #  #  #
#  #  #           #     #  #  #
#  #  #  #  #  ####  ####  ####
#     #  #  #     #  #  #     #
####  #  #  ####  ####  #  #  #
#  #  #  #     #           #  #
#  #  #######  #######  #######
#     #  #           #        #
####  #  #  ####  ##########  #
#              #           #  #
#  ####  #  ####  ##########  #
#  #  #  #     #  #        #  #
#  #  #  #  ####  #  ####  #  #
#     #  #  #     #  #     #  #
#  #  #############  ####  #  #
#  #           #  #     #  #  #
#  ####  #######  #  #######  #
#     #     #     #  #  #     #
#  ####  ####  #  #  #  #######
#  #  #  #  #  #     #     #  #
####  #  #  #  ####  ####  #  #
#        #     #     #        #
####  ####  #  #######  #  ####
#           #  #        #  #  #
#  #  ##########  ####  #  #  #
#  #              #     #     #
####  ####  ##########  ####  #
#     #  #     #  #     #     #
#  #  #  #  #  #  #######  ####
#  #  #     #     #     #  #  #
#######  ####  #######  #  #  #
#  #     #     #        #     #
#  #######  #  #  ##########  #
#  #  #     #     #  #  #     #
#  #  ####  ####  #  #  #  #  #
#     #  #  #           #  #  #
#  ####  #  #######  #  ####  #
#           #        #  #     #
#A#############################
