########################################################################################################################################################################################################################################################################################A####################
#  #        #        #     #  #        #        #  #  #     #                       #     #     #  #     #        #        #     #        #     #  #        #                 #        #        #     #     #     #           #  #     #     #  #     #        #           #  #  #           #  #  #        #
#  #  ####  #  #  #  #  #  #  #  #  #  #  #######  #  ####  #  #  ####  #  ##########  #  #  #  #  #  #######  ####  #######  ####  ##########  #  #######  ####  #  ####  #######  ####  #######  #######  #  ##########  ####  #  #  ####  #  ####  #  #  #  ####  #######  #  #######  ####  #  #  #  ####
#     #        #  #     #        #  #           #           #  #     #  #           #  #     #  #     #                       #  #              #     #        #  #     #           #     #        #  #        #     #  #  #        #        #  #        #  #     #        #     #           #     #  #     #
####  ##########  #  #  ##########  ##########  ####  ####  ####  #######  ##########  ####  #######  ####  #  ################  #######  ####  #  #  #######  ####  ##########  ####  ##########  #  #  ####  ####  #  #  ####  #############  ##########  ####  #  #  ####  ##########  #######  #  #######
#           #     #  #  #        #     #        #        #     #        #     #  #     #        #     #     #     #     #  #        #        #  #  #  #  #        #     #                    #           #        #                    #  #        #  #        #     #     #  #     #  #     #     #        #
#  #############  ####  ####  ####  #  ####  #  #############  #######  #######  ####  #  ####  #  #############  ####  #  ####  #  #  #######  #  ####  #  ####  #  #######  #######  #######  #  #  ####  #  #  #  #  #  ####  #  ####  #  #######  ####  #######  #######  #  #  #  #  #  #  #  #######  #
#  #  #  #     #  #  #  #        #  #     #  #  #     #              #                 #  #  #  #     #                          #  #  #     #           #  #  #           #     #              #  #  #     #  #  #  #  #     #  #     #  #                 #     #        #     #     #  #     #           #
#  #  #  ####  #  #  ##########  ##########  #######  ####  #######  #######  ####  #######  ####  #  ####  #  #############  #######  ####  #  #############  #  ##########  ##########  #######  ####  ####  #  #############  #  ####  #  #######  #######  ####  #######  ####  ####  ##########  #######
#     #                    #        #  #  #           #     #     #     #     #              #     #  #     #              #     #     #              #  #  #           #     #  #  #     #  #  #     #     #  #  #  #        #  #  #              #  #        #  #           #  #     #     #  #  #        #
#  #######  ###################  ####  #  #  ####  #  ##########  #  #  ##########  #######  ####  ####  #############  #######  #######  #######  #  #  #  #  ##########  ####  #  ####  #  #  #  #  ####  ####  #  ####  #  #  #  ####  #  #######  ####  #  #  ####  #  #  #  ####  ####  #  #  ####  #  #
#     #     #  #     #        #  #     #     #  #  #  #  #     #     #           #     #  #  #        #  #     #           #     #  #  #     #     #  #     #  #        #        #              #  #  #  #     #  #        #  #  #        #  #  #  #  #     #  #        #  #  #        #  #        #  #  #  #
#  #######  #  #  ##########  #  ####  #######  #  ####  #  ##########  #######  #######  #  ####  #######  #############  #######  #  ##########  ####  #  ####  ##########  ####  ##########  #  ####  #######  #  ################  ####  #  #  #######  #  #######  #  #######  ####  #  #######  #  ####
#        #  #           #  #              #                 #        #     #  #  #              #  #  #     #           #                       #  #     #  #     #  #  #        #           #  #  #              #  #  #     #           #     #  #     #  #  #        #  #           #     #     #        #
#  ####  #  #  #  #######  ####  #  ####  #  #  #  #######  #  ####  #######  #  #  ####  #  #  #  #  ####  #  ####  #######  #######  #  #  ####  #  #  ####  ####  #  #  #######  #  ####  ####  ##########  #  #  #  ####  #  #############  #  ####  #  #  #  #  #######  #######  #  ####  #  ##########
#  #     #     #  #        #  #  #     #  #  #  #     #     #  #  #     #        #     #  #  #     #        #     #        #     #  #  #  #        #  #              #  #  #     #  #     #  #           #  #  #        #           #     #     #  #     #  #     #  #     #  #  #     #  #  #  #     #     #
#  ####  #  ####  #  ####  #  ####  #  ####  #  ####  ####  ####  #  #  #  ####  #  ##########  #######  #  #  ################  #  #######  ####  #  #  #  #  ####  #  #  #  #######  #  ##########  #  #  #######  #  ####  ####  #  ####  ####  ####  #  #  ####  ####  #  #  ####  #  #  #######  #  ####
#  #     #  #  #        #     #     #     #  #  #  #     #           #  #     #           #  #           #           #     #              #     #     #  #  #  #     #           #     #  #           #        #  #  #           #     #           #        #  #           #  #  #                          #
#  ##########  #  ####  #  #######  #  #  #  #  #  #  #  #  #######  ####  ####  #  ####  #  #  #############  ####  #  ####  #  #  ####  ##########  #  #  ####  ####  ####  ####  #############  ##########  #  #  #  #  #  ##########  #  #  #######  #######  #  ####  ####  #  ####  #######  #######  #
#        #           #  #     #     #  #     #     #  #  #  #                 #  #  #        #        #           #           #  #  #        #        #  #     #        #     #              #              #     #  #  #  #        #     #  #  #              #  #     #        #  #           #  #        #
#############################################################################################################################################################################################################################################################################################################
